0 0 0 0 0 0 0 0 0 0
0 0 0 9 0 0 9 0 0 0
0 0 5 4 5 5 4 5 0 0
0 0 5 4 0 0 4 5 0 0
0 9 4 0 0 0 0 4 9 0
0 2 4 0 5 5 0 4 2 0
0 2 4 0 5 5 0 4 2 0
0 0 1 4 0 0 4 1 0 0
0 0 1 4 0 0 4 1 0 0
0 0 0 1 4 4 1 0 0 0
0 0 0 1 4 4 1 0 0 0
0 0 0 0 0 0 0 0 0 0
0 0 0 0 0 0 0 0 0 0
