7 0 0 0 7 0 10 10 9 0
1 0 0 0 1 0 10 0 0 0
1 0 7 0 1 0 10 10 9 0
1 0 1 0 1 0 10 0 0 0
0 1 0 1 0 0 9 0 0 0
0 0 0 0 0 0 0 0 0 0
0 2 2 8 0 0 4 4 0 0
0 2 0 0 0 4 0 0 6 0
0 2 0 0 0 4 0 0 0 0
0 2 2 2 0 4 0 6 0 0
0 0 0 2 0 4 0 0 4 0
0 0 0 2 0 4 0 0 4 0
0 8 2 2 0 0 4 4 0 0