0 0 0 0 0 0 0 0 0 0
0 0 2 2 2 2 2 2 0 0
6 0 2 2 2 2 2 9 0 6
5 6 0 0 0 0 0 0 6 5
0 5 5 3 3 3 3 5 5 0
4 0 5 5 0 0 5 5 0 4
0 4 0 0 9 9 0 0 4 0
0 0 4 4 0 0 4 4 0 0
3 7 3 3 8 8 3 3 7 7
9 7 0 0 0 0 0 0 7 0
0 0 1 1 1 1 1 1 0 0
0 0 1 1 1 1 1 1 0 0
0 0 0 0 0 0 0 0 0 0